NO ./texture/anya.xpm
SO ./texture/regen.xpm
WE ./texture/dio.xpm
EA ./texture/bird.xpm


F 220,100,0
C 225,30,0

1111111111111111111111
1000000000000000000001
1010100000011100111101
1000000000000000111101
1111000001000010000011
1000001000000000001001
100000000000000000000111111111111111
100000000001000000001111000001101111
100111000000000010000000000010000001
10000011000N000010000010000000000011
100000000000000000000000000000000001
111111111111111111111111111111111111