NO ./texture/wood_test.xpm
SO ./texture/wall_south.xpm
WE ./texture/wall_west.xpm
EA ./texture/wall_ea.xpm


F 120,120,120
C 20,0,139

1111111111111111
1000100110001001
1000000110001001
1000000110001001
1000100110001001
1000000110001001
1000000111111111
10001001
10001001
10N01001
10001001
11111111