NO ./texture/wood_test.xpm
SO ./texture/wall_south.xpm
WE ./texture/wall_west.xpm
EA ./texture/wall_ea.xpm


F 120,120,120
C 20,0,139

11111111
10000001
10000001
10001001
10N01001
10001001
11111111