NO ./texture/wood_test.xpm
SO ./texture/wall_south.xpm
WE ./texture/wall_west.xpm
EA ./texture/wall_ea.xpm

F 120,120,120
C 20,0,139

1111111111111
100000S000001
1111111111111
1111111111111
