NO texture/path_to_the_north_texture
SO texture/path_to_the_south_texture
WE texture/path_to_the_west_texture
EA texture/path_to_the_east_texture


F 220,100,0
C 255,30,0

1111111
1000001
10N1001
1000001
1111111
1111111