NO ./texture/wood_test.xpm
SO ./texture/wall_south.xpm
WE ./texture/wall_west.xpm
EA ./texture/wall_ea.xpm


F 120,120,120
C 20,0,139

11111111111111111111111
10001001100010000000001
10000001100000011111111
1010010000000101
1000100110001001         1111
1000N00110001001
1010010111111111
10001001    1001
10001001    111111    111111
10001001    100001
10001001    111111
1111111111111111111