NO ./texture/wood_test.xpm
SO ./texture/path_to_the_south_texture.xpm
WE ./texture/path_to_the_west_texture.xpm
EA ./texture/test_texture.xpm


F 220,100,0
C 255,30,0

11111111
10000001
10000001
10001001
10N01001
10001001
11111111